Time,!x,!y,!z,Protein(),Gate(),Gate2(),Gate3()
0.,3,6,8,17,0,0,300
134.137734965,3,6,6,15,0,0,300
242.593185168,2,5,6,13,0,0,300
348.490380178,2,3,5,10,0,0,300
458.532711917,2,1,3,6,0,0,300
590.02122435,1,1,3,5,0,0,300
778.073368415,1,1,2,4,0,0,300
881.254086106,1,1,1,3,0,0,300
1004.46342205,2,1,1,4,0,0,300
1173.39495913,2,1,1,4,0,0,300
1275.0013644,19,1,0,20,2,0,298
1378.55325995,43,1,0,44,2,0,298
1479.48280362,54,1,0,55,3,0,297
1579.83980628,91,1,0,92,4,0,296
1681.23099658,126,1,0,127,5,0,295
1782.83259396,174,1,0,175,5,0,295
1883.85449004,212,1,0,213,5,0,295
1984.18529439,233,1,0,234,5,0,295
2086.57965054,263,1,0,264,7,0,293
2187.23878227,283,1,0,284,7,0,293
2289.13484156,332,1,0,333,8,0,292
2389.46605618,380,1,0,381,8,0,292
2489.61456749,428,1,0,429,8,0,292
2590.73335179,481,1,0,482,10,0,290
2691.61567454,549,1,0,550,11,0,289
2793.55131669,593,1,0,594,11,0,289
2894.28819044,632,1,0,633,12,0,288
2994.31417379,607,1,1,609,0,0,300
3095.15616705,532,1,1,534,0,0,300
3197.47344703,486,1,1,488,0,0,300
3299.82648206,447,0,1,448,0,0,300
3402.23931446,396,0,1,397,0,0,300
3507.75977196,359,0,16,375,3,0,297
3610.24136441,325,0,51,376,6,0,294
3711.71226677,303,0,97,400,6,0,294
3812.1664917,271,0,133,404,6,0,294
3913.01021332,249,0,188,437,7,0,293
4015.34806048,221,0,246,467,7,0,293
4115.71578792,200,0,289,489,7,0,293
4215.81009146,185,0,334,519,7,0,293
4316.61929868,167,0,379,546,10,0,290
4417.4676756,147,0,446,593,10,0,290
4517.4889598,135,0,508,643,10,0,290
4617.88245061,118,0,561,679,10,0,290
4717.9231241,110,0,590,700,10,0,290
4818.12447583,103,0,626,729,10,0,290
4918.29793318,96,0,669,765,11,0,289
5018.40269928,88,0,725,813,14,0,286
5120.30118181,79,0,840,919,14,0,286
5220.42363878,71,0,898,969,15,0,285
5320.81121918,64,0,988,1052,16,0,284
5421.65298533,59,0,1025,1084,16,0,284
5521.81999618,54,0,1051,1105,16,0,284
5621.86037209,47,0,1092,1139,16,0,284
5721.95639669,44,0,1154,1198,18,0,282
5822.08795503,34,0,1215,1249,18,0,282
5922.16561961,32,0,1277,1309,18,0,282
6022.41035922,30,0,1335,1365,18,0,282
6122.81275909,28,0,1374,1402,18,0,282
6223.91702391,27,0,1408,1435,18,0,282
6324.65546552,22,0,1461,1483,18,0,282
6424.94678025,18,0,1513,1531,19,0,281
6524.97425658,17,0,1549,1566,21,0,279
6625.10134374,17,0,1601,1618,21,0,279
6725.376644,16,0,1681,1697,21,0,279
6825.49726633,14,0,1720,1734,21,0,279
6925.55585114,13,0,1740,1753,21,0,279
7025.58283202,9,0,1748,1757,21,0,279
7125.63403933,9,0,1790,1799,21,0,279
7225.8306445,5,0,1828,1833,21,0,279
7325.88169822,5,0,1881,1886,21,0,279
7426.41198505,4,0,1923,1927,21,0,279
7526.84254529,4,0,1945,1949,22,0,278
7627.34806461,3,0,1987,1990,24,0,276
7727.44138894,3,0,2041,2044,24,0,276
7827.56544476,3,1,1854,1858,0,0,300
7927.95975296,3,1,1681,1685,0,0,300
8029.65217145,3,0,1511,1514,0,0,300
8129.74019839,2,0,1393,1395,3,0,297
8229.84084571,2,0,1292,1294,4,0,296
8329.93725283,2,0,1180,1182,4,0,296
8430.42273884,2,0,1101,1103,4,0,296
8532.37652208,2,0,1043,1045,4,0,296
8633.88830846,1,0,975,976,5,0,295
8734.56105642,1,0,917,918,6,0,294
8836.1255323,1,0,875,876,6,0,294
8937.29215847,1,0,858,859,8,0,292
9037.40337936,1,0,858,859,8,0,292
9138.31046422,1,0,855,856,8,0,292
9238.33309906,1,0,854,855,8,0,292
9339.46896224,1,0,859,860,11,0,289
9440.01507355,1,0,924,925,13,0,287
9540.91151406,1,0,961,962,13,0,287
9640.9173884,1,0,990,991,14,0,286
9741.13557727,1,0,1054,1055,16,0,284
9841.77606198,1,0,1109,1110,16,0,284
9941.91263308,1,0,1174,1175,16,0,284
10042.589913,1,0,1215,1216,16,0,284
10142.7808089,1,1,1164,1166,0,0,300
10243.5938369,1,1,1055,1057,0,0,300
10343.9321557,1,1,965,967,0,0,300
10444.6766794,1,1,872,874,0,0,300
10545.4972796,0,1,801,802,0,0,300
10645.9268494,0,7,722,729,1,0,299
10747.0635967,0,19,642,661,2,0,298
10848.4705745,0,37,590,627,2,0,298
10949.3534535,0,52,537,589,2,0,298
11050.4750069,0,62,469,531,3,0,297
11153.000091,0,85,422,507,4,0,296
11255.9249756,0,122,374,496,6,0,294
11356.9331202,0,168,341,509,7,0,293
11457.0430833,0,234,309,543,8,0,292
11557.8415775,0,281,278,559,8,0,292
11659.0027321,0,332,250,582,9,0,291
11759.5186979,0,408,232,640,9,0,291
11859.9266427,0,443,209,652,9,0,291
11960.2113859,0,506,193,699,11,0,289
12060.9011167,0,600,172,772,13,0,287
12160.9829623,0,645,151,796,13,0,287
12261.1908657,0,719,137,856,15,0,285
12361.8406982,0,799,120,919,17,0,283
12462.1829561,0,894,109,1003,19,0,281
12562.4193917,0,988,105,1093,21,0,279
12662.6560271,0,1111,96,1207,21,0,279
12762.8767628,0,1220,89,1309,22,0,278
12863.0359374,0,1324,84,1408,22,0,278
12963.8215798,0,1409,75,1484,22,0,278
13064.3028925,0,1474,73,1547,22,0,278
13164.4040001,0,1564,68,1632,22,0,278
13265.376974,0,1638,58,1696,22,0,278
13365.4763124,0,1687,53,1740,23,0,277
13465.5891355,0,1797,49,1846,25,0,275
13565.7309607,0,1843,43,1886,25,0,275
13665.8609712,0,1913,40,1953,25,0,275
13766.1157286,0,1968,39,2007,26,0,274
13866.1604321,0,2033,35,2068,28,0,272
13966.5090386,0,2147,31,2178,29,0,271
14066.6485152,0,2217,28,2245,29,0,271
14166.8777312,0,2290,24,2314,29,0,271
14267.0767136,0,2361,22,2383,30,0,270
14367.1305509,0,2403,19,2422,32,0,268
14467.958206,0,2450,18,2468,33,0,267
14568.0084901,0,2528,17,2545,34,0,266
14668.1095463,0,2612,15,2627,34,0,266
14768.1880575,0,2681,13,2694,35,0,265
14868.6531547,0,2777,13,2790,36,0,264
14968.9339983,0,2869,11,2880,37,0,263
15069.0181767,0,2969,9,2978,37,0,263
15169.0758422,0,3002,7,3009,37,0,263
15269.2126541,0,3119,7,3126,38,0,262
15369.2269012,0,3169,7,3176,38,0,262
15469.4253137,0,3203,6,3209,38,0,262
15569.4467307,0,3247,6,3253,38,0,262
15669.7681599,0,3307,6,3313,38,0,262
15769.7937164,0,3319,6,3325,39,0,261
15869.8418273,0,3326,5,3331,39,0,261
15970.075323,0,3384,3,3387,39,0,261
16070.1711721,0,3450,3,3453,39,0,261
16170.1971731,0,3504,3,3507,39,0,261
16270.3045697,0,3531,3,3534,40,0,260
16370.3153976,0,3585,3,3588,41,0,259
16470.5784751,0,3616,3,3619,43,0,257
16570.8580739,0,3713,3,3716,43,0,257
16671.0623713,0,3765,3,3768,43,0,257
16771.1608984,0,3847,3,3850,43,0,257
16871.6038094,0,3925,3,3928,43,0,257
16972.0134454,0,3960,3,3963,46,0,254
17072.0973407,0,3997,2,3999,47,0,253
17172.1320872,1,3848,2,3851,0,0,300
17272.7323699,1,3485,1,3487,0,0,300
17372.8236799,0,3160,1,3161,2,0,298
17472.8296299,0,2877,1,2878,3,0,297
17573.3066821,1,2596,1,2598,0,0,300
17673.6221569,1,2362,1,2364,0,0,300
17775.0155652,0,2140,1,2141,1,0,299
17875.1806453,0,1960,1,1961,2,0,298
17975.269717,0,1792,1,1793,4,0,296
18075.5157212,0,1672,1,1673,4,0,296
18175.7757478,0,1552,1,1553,6,0,294
18275.8318074,0,1478,1,1479,8,0,292
18376.0427297,0,1417,1,1418,10,0,290
18476.0735825,1,1405,0,1406,1,0,299
18576.0926792,14,1278,0,1292,2,0,298
18677.2663948,39,1148,0,1187,2,0,298
18777.3148918,52,1041,0,1093,3,0,297
18877.4361067,71,937,0,1008,4,0,296
18977.6786517,104,848,0,952,4,0,296
19077.8585154,159,768,0,927,6,0,294
19177.9798792,201,679,0,880,8,0,292
19278.0734884,245,617,0,862,8,0,292
19378.0938617,301,553,0,854,9,0,291
19478.2134075,351,501,0,852,10,0,290
19578.596284,392,454,0,846,10,0,290
19678.6323974,450,424,0,874,12,0,288
19778.7037439,516,390,0,906,12,0,288
19878.9315396,585,358,0,943,13,0,287
19979.1426365,654,333,0,987,13,0,287
20079.506791,703,302,0,1005,14,0,286
20180.3257125,778,272,0,1050,14,0,286
20280.5946739,860,242,0,1102,16,0,284
20381.275489,908,213,0,1121,16,0,284
20481.7333935,974,193,0,1167,19,0,281
20581.7799188,1060,177,0,1237,19,0,281
20681.9344736,1110,157,0,1267,19,0,281
20781.934882,1196,137,0,1333,19,0,281
20882.3525715,1257,113,0,1370,19,0,281
20982.9797929,1320,100,0,1420,20,0,280
21083.0027302,1373,96,0,1469,21,0,279
21183.292959,1455,85,0,1540,23,0,277
21283.4786162,1559,78,0,1637,25,0,275
21383.5029597,1643,71,0,1714,25,0,275
21483.7421517,1737,67,0,1804,25,0,275
21583.7563845,1826,62,0,1888,26,0,274
21684.6862395,1907,52,0,1959,26,0,274
21784.7687609,1971,44,0,2015,26,0,274
21884.8349222,1997,43,0,2040,28,0,272
21985.0676228,2105,35,0,2140,31,0,269
22085.0773137,2211,34,0,2245,32,0,268
22185.2804821,2321,34,0,2355,32,0,268
22285.357114,2418,31,0,2449,33,0,267
22385.4059174,2497,29,0,2526,34,0,266
22485.4985842,2576,27,0,2603,35,0,265
22585.5034551,2701,25,0,2726,36,0,264
22685.5674075,2809,25,0,2834,38,0,262
22785.5730421,2864,22,0,2886,38,0,262
22885.599896,2973,22,0,2995,38,0,262
22985.8117313,3038,21,0,3059,38,0,262
23085.9136702,3118,21,0,3139,38,0,262
23185.9230768,3184,19,0,3203,38,0,262
23285.9905943,3220,16,0,3236,38,0,262
23385.9951912,3288,14,0,3302,40,0,260
23486.2118526,3318,10,0,3328,40,0,260
23586.2899789,3393,9,0,3402,40,0,260
23686.3192503,3460,9,0,3469,40,0,260
23786.4334146,3538,9,0,3547,41,0,259
23886.8944966,3564,8,0,3572,41,0,259
23987.1293493,3583,6,0,3589,41,0,259
24087.186757,3684,6,0,3690,43,0,257
24187.2442709,3685,5,0,3690,43,0,257
24287.3050102,3810,4,0,3814,43,0,257
24387.6787397,3850,4,0,3854,43,0,257
24487.7380397,3906,4,0,3910,43,0,257
24587.9893315,3958,4,0,3962,43,0,257
24688.015578,4008,3,0,4011,43,0,257
24788.1394669,4043,3,0,4046,43,0,257
24888.2316595,4071,3,0,4074,44,0,256
24988.265269,4119,3,0,4122,45,0,255
25088.2689149,4150,3,0,4153,46,0,254
25188.6198163,4172,3,0,4175,46,0,254
25288.7787094,4143,3,0,4146,47,0,253
25388.7963074,4202,2,0,4204,47,0,253
25488.8042933,4188,2,0,4190,47,0,253
25588.845877,4262,2,0,4264,47,0,253
25688.848495,4329,2,0,4331,48,0,252
25788.9006899,4423,2,0,4425,50,0,250
25888.9403397,4472,2,0,4474,51,0,249
25989.0093928,4555,2,0,4557,51,0,249
26089.0801187,4615,2,0,4617,51,0,249
26189.1199692,4633,2,0,4635,51,0,249
26289.2038213,4712,2,0,4714,52,0,248
26389.3858468,4776,2,0,4778,52,0,248
26489.5477963,4802,2,0,4804,52,0,248
26589.5633428,4863,2,0,4865,52,0,248
26689.6381731,4865,2,0,4867,52,0,248
26789.9675803,4943,2,0,4945,52,0,248
26889.9797192,4839,2,1,4842,0,0,300
26990.1635515,4376,2,1,4379,0,0,300
27090.5112013,3948,2,1,3951,0,0,300
27190.6227141,3616,2,1,3619,0,0,300
27291.0262112,3271,2,2,3275,0,0,300
27391.1795864,2954,2,2,2958,0,0,300
27491.482642,2680,1,2,2683,0,0,300
27591.9284561,2415,1,2,2418,0,0,300
27692.0607202,2189,1,2,2192,0,0,300
27792.2819825,1984,1,2,1987,0,0,300
27892.6214558,1773,1,2,1776,0,0,300
27993.737336,1621,1,2,1624,0,0,300
28093.8515793,1480,0,1,1481,0,0,300
28194.3144874,1332,0,7,1339,1,0,299
28294.4697888,1196,0,20,1216,1,0,299
28395.9059283,1086,0,25,1111,1,0,299
28496.0440191,964,0,48,1012,4,0,296
28596.880493,872,0,81,953,4,0,296
28697.3466098,787,0,117,904,5,0,295
28797.7799102,717,0,157,874,6,0,294
28898.1757019,638,0,194,832,7,0,293
28998.5655476,579,0,246,825,10,0,290
29100.6297689,527,0,296,823,10,0,290
29200.9937158,472,0,358,830,12,0,288
29301.0076991,431,0,429,860,13,0,287
29401.3658111,394,0,514,908,16,0,284
29502.1319419,353,0,612,965,16,0,284
29602.965924,323,0,699,1022,16,0,284
29703.7140002,290,0,760,1050,16,0,284
29803.788394,263,0,826,1089,16,0,284
29904.0792057,239,0,904,1143,16,0,284
30004.3673507,216,0,964,1180,19,0,281
30104.6019436,196,0,1080,1276,20,0,280
30204.931466,182,0,1188,1370,22,0,278
30305.0243165,165,0,1338,1503,23,0,277
30405.3353336,152,0,1440,1592,23,0,277
30505.4030983,138,0,1544,1682,24,0,276
30605.602288,127,0,1624,1751,26,0,274
30705.6050705,108,0,1712,1820,26,0,274
30805.6883149,93,0,1816,1909,27,0,273
30905.8139712,83,0,1891,1974,27,0,273
31005.8330602,74,0,1995,2069,28,0,272
31105.9084532,67,0,2096,2163,28,0,272
31206.0773065,60,0,2157,2217,28,0,272
31306.23791,59,0,2232,2291,29,0,271
31406.3373382,56,0,2303,2359,31,0,269
31506.4436114,54,0,2409,2463,31,0,269
31606.8231366,48,0,2476,2524,31,0,269
31706.8640274,46,0,2501,2547,32,0,268
31806.9904076,39,0,2615,2654,33,0,267
31907.2793514,34,0,2691,2725,36,0,264
32007.3129106,31,0,2790,2821,36,0,264
32107.462962,29,0,2858,2887,37,0,263
32207.7052032,26,0,2942,2968,37,0,263
32307.8277958,25,0,2995,3020,38,0,262
32407.8484889,24,0,3048,3072,38,0,262
32507.8875569,22,0,3034,3056,38,0,262
32607.9056659,20,0,3146,3166,38,0,262
32708.0242166,18,0,3205,3223,38,0,262
32808.2136443,14,0,3244,3258,38,0,262
32908.284232,12,0,3337,3349,38,0,262
33008.3301794,10,0,3352,3362,38,0,262
33108.3480324,10,0,3376,3386,38,0,262
33208.4778685,7,0,3426,3433,40,0,260
33308.5048795,7,0,3436,3443,42,0,258
33408.5537513,7,0,3525,3532,42,0,258
33508.9617381,7,0,3564,3571,42,0,258
33609.0356345,6,0,3655,3661,44,0,256
33709.0489352,6,0,3733,3739,46,0,254
33809.0632508,5,0,3836,3841,47,0,253
33909.1680039,5,0,3917,3922,48,0,252
34009.383888,5,0,4008,4013,48,0,252
34109.3862995,4,0,4129,4133,48,0,252
34209.9249287,4,0,4154,4158,48,0,252
34309.9392392,4,0,4231,4235,48,0,252
34410.0156304,4,0,4257,4261,49,0,251
34510.103228,3,0,4332,4335,50,0,250
34610.1243408,3,0,4372,4375,50,0,250
34710.1979097,3,0,4375,4378,50,0,250
34810.8389515,3,0,4430,4433,50,0,250
34911.090537,3,0,4463,4466,50,0,250
35011.2682406,3,0,4545,4548,50,0,250
35111.2900159,2,0,4581,4583,50,0,250
35211.45446,2,0,4615,4617,51,0,249
35311.4724953,2,0,4678,4680,52,0,248
35411.5798702,2,0,4698,4700,52,0,248
35511.5900241,2,0,4756,4758,52,0,248
35611.6969437,2,0,4805,4807,53,0,247
35711.8380466,1,0,4867,4868,53,0,247
35811.8414224,1,0,4949,4950,53,0,247
35912.1390953,1,2,4514,4517,0,0,300
36012.9043088,1,1,4070,4072,0,0,300
36113.1811375,1,0,3689,3690,1,0,299
36213.6853352,1,0,3348,3349,2,0,298
36313.9883492,1,0,3044,3045,3,0,297
36414.0461303,1,1,2776,2778,0,0,300
36514.3210755,1,1,2502,2504,0,0,300
36614.4693643,1,1,2279,2281,0,0,300
36715.0786687,1,1,2047,2049,0,0,300
36815.4527521,0,1,1833,1834,0,0,300
36916.4984499,0,3,1657,1660,1,0,299
37016.5024239,0,16,1501,1517,1,0,299
37116.5426285,0,21,1342,1363,1,0,299
37217.4929815,0,37,1195,1232,2,0,298
37320.2356667,0,60,1070,1130,3,0,297
37420.2798729,0,89,965,1054,4,0,296
37521.0402594,0,117,876,993,4,0,296
37622.8899948,0,146,800,946,6,0,294
37723.2385906,0,210,729,939,9,0,291
37823.3338431,0,296,653,949,11,0,289
37924.2705067,0,418,600,1018,14,0,286
38024.3301596,0,513,548,1061,14,0,286
38124.4812933,0,605,500,1105,16,0,284
38225.2486519,0,714,443,1157,16,0,284
38325.7669319,0,814,408,1222,16,0,284
38425.9880089,0,886,374,1260,18,0,282
38526.0359502,0,991,342,1333,19,0,281
38626.0407142,0,1097,311,1408,20,0,280
38726.0872708,0,1196,278,1474,21,0,279
38826.1163253,0,1284,243,1527,21,0,279
38926.3039869,0,1407,221,1628,22,0,278
39026.5159058,0,1494,205,1699,22,0,278
39126.9028739,0,1552,185,1737,22,0,278
39227.212799,0,1622,169,1791,23,0,277
39327.5082053,0,1695,154,1849,24,0,276
39427.7150368,0,1761,142,1903,24,0,276
39527.8800634,0,1844,125,1969,25,0,275
39628.1477949,0,1915,113,2028,25,0,275
39728.3220432,0,1962,102,2064,25,0,275
39828.3305922,0,2042,94,2136,27,0,273
39928.8380008,0,2112,84,2196,27,0,273
40028.9831025,0,2206,74,2280,29,0,271
40129.0253184,0,2291,63,2354,32,0,268
40229.4626434,0,2384,58,2442,33,0,267
40329.719476,0,2512,51,2563,33,0,267
40429.7516885,0,2600,45,2645,34,0,266
40529.8278253,0,2691,39,2730,36,0,264
40629.952565,0,2745,37,2782,36,0,264
40730.4980018,0,2837,34,2871,36,0,264
40830.6376258,0,2879,33,2912,36,0,264
40931.1805961,0,2993,31,3024,37,0,263
41031.3315825,0,3097,27,3124,37,0,263
41131.4580569,0,3167,26,3193,38,0,262
41231.4674557,0,3233,24,3257,39,0,261
41331.5163772,0,3306,23,3329,40,0,260
41431.5166541,0,3396,19,3415,40,0,260
41531.5528214,0,3492,18,3510,40,0,260
41631.6778317,0,3580,16,3596,41,0,259
41731.7545072,0,3597,14,3611,42,0,258
41831.945403,0,3656,9,3665,42,0,258
41932.3900402,0,3678,7,3685,42,0,258
42032.460831,0,3697,7,3704,43,0,257
42132.5938053,0,3712,7,3719,43,0,257
42232.6688544,0,3795,7,3802,43,0,257
42332.7012887,0,3823,6,3829,46,0,254
42432.7413582,0,3865,6,3871,47,0,253
42532.7554649,0,3939,5,3944,47,0,253
42632.9626423,0,4006,4,4010,48,0,252
42733.0504412,0,4102,4,4106,49,0,251
42833.1044988,0,4166,3,4169,49,0,251
42933.1096518,0,4280,3,4283,50,0,250
43033.2355219,0,4365,3,4368,50,0,250
43133.3726875,0,4413,3,4416,50,0,250
43233.4546354,0,4448,3,4451,51,0,249
43333.4555884,0,4518,3,4521,51,0,249
43433.4611666,0,4556,3,4559,51,0,249
43533.8878275,0,4608,2,4610,51,0,249
43633.9281581,0,4659,2,4661,52,0,248
43734.0261026,0,4713,2,4715,52,0,248
43834.3215792,0,4727,2,4729,52,0,248
43934.3462895,0,4724,2,4726,52,0,248
44034.3744235,0,4761,2,4763,53,0,247
44134.4708309,0,4849,2,4851,56,0,244
44234.5794429,0,4929,1,4930,56,0,244
44334.6400847,1,4446,1,4448,0,0,300
44434.9103349,1,4041,1,4043,0,0,300
44535.4925187,1,3660,1,3662,0,0,300
44635.5161123,2,3317,0,3319,2,0,298
44737.0468499,38,3018,0,3056,5,0,295
44837.5401165,99,2724,0,2823,6,0,294
44937.7304755,166,2453,0,2619,7,0,293
45037.8336888,233,2229,0,2462,8,0,292
45138.2194125,289,2023,0,2312,9,0,291
45238.6657996,350,1822,0,2172,10,0,290
45338.8970212,410,1661,0,2071,11,0,289
45439.1528851,469,1485,0,1954,12,0,288
45539.2843059,522,1357,0,1879,13,0,287
45639.3891231,599,1221,0,1820,13,0,287
45739.665813,673,1112,0,1785,14,0,286
45840.9225778,740,989,0,1729,14,0,286
45941.1537689,826,886,0,1712,17,0,283
46041.437958,899,811,0,1710,17,0,283
46141.49634,977,732,0,1709,19,0,281
46242.1783595,1058,674,0,1732,20,0,280
46342.4484565,1137,612,0,1749,20,0,280
46442.5746412,1235,562,0,1797,20,0,280
46542.7256004,1301,510,0,1811,20,0,280
46642.9461229,1355,465,0,1820,21,0,279
46743.292574,1463,419,0,1882,22,0,278
46843.472103,1515,382,0,1897,23,0,277
46943.8761853,1585,339,0,1924,23,0,277
47044.1080935,1603,306,0,1909,25,0,275
47144.2937392,1707,270,0,1977,25,0,275
47244.4236503,1784,243,0,2027,26,0,274
47344.6175068,1867,216,0,2083,26,0,274
47444.7680653,1940,196,0,2136,27,0,273
47544.8623552,1981,178,0,2159,28,0,272
47645.1219515,2066,161,0,2227,29,0,271
47745.7889573,2141,146,0,2287,30,0,270
47845.9353893,2265,134,0,2399,31,0,269
47946.0276855,2357,119,0,2476,33,0,267
48046.0450263,2470,113,0,2583,35,0,265
48146.0908204,2557,106,0,2663,35,0,265
48246.3058123,2641,95,0,2736,35,0,265
48346.4038157,2693,88,0,2781,35,0,265
48446.6746635,2785,81,0,2866,35,0,265
48546.7062561,2844,74,0,2918,35,0,265
48646.7988538,2897,70,0,2967,37,0,263
48746.8074136,2989,65,0,3054,40,0,260
48846.8891736,3076,58,0,3134,40,0,260
48947.0477103,3171,56,0,3227,41,0,259
49047.1439546,3310,49,0,3359,41,0,259
49147.4309218,3377,46,0,3423,41,0,259
49247.6754208,3427,44,0,3471,41,0,259
49347.8425555,3460,41,0,3501,42,0,258
49447.9596693,3527,36,0,3563,42,0,258
49547.9644383,3652,31,0,3683,42,0,258
49648.0028994,3747,29,0,3776,43,0,257
49748.0964439,3802,27,0,3829,43,0,257
49848.1256426,3848,24,0,3872,44,0,256
49948.2519693,3941,20,0,3961,44,0,256
50048.3369137,3984,18,0,4002,45,0,255
50148.3670234,4051,15,0,4066,46,0,254
50248.5180567,4070,14,0,4084,47,0,253
50348.5950215,4109,12,0,4121,47,0,253
50448.7605234,4134,11,0,4145,47,0,253
50548.8707634,4201,8,0,4209,47,0,253
50649.0656458,4248,8,0,4256,47,0,253
50749.1318811,4239,8,0,4247,48,0,252
50849.1929716,4290,8,0,4298,49,0,251
50949.2152779,4335,6,0,4341,49,0,251
51049.6337525,4402,5,0,4407,49,0,251
51149.6806166,4435,5,0,4440,50,0,250
51249.7521523,4519,5,0,4524,51,0,249
51349.8496557,4590,4,0,4594,52,0,248
51450.1759065,4624,4,0,4628,52,0,248
51550.2749698,4716,3,0,4719,52,0,248
51650.3037967,4774,3,0,4777,54,0,246
51750.3447168,4846,1,0,4847,55,0,245
51850.4683357,4863,1,0,4864,55,0,245
51950.5002929,4925,1,0,4926,56,0,244
52050.513523,4992,1,0,4993,57,0,243
52150.523075,5034,1,0,5035,57,0,243
52251.0447707,4924,0,4,4928,2,0,298
52351.1134024,4424,0,33,4457,3,0,297
52451.1925025,4003,0,71,4074,4,0,296
52551.2696634,3576,0,92,3668,5,0,295
52651.6226301,3238,0,146,3384,7,0,293
52751.6324173,2914,0,195,3109,7,0,293
52852.3190646,2658,0,245,2903,7,0,293
52953.1037461,2410,0,287,2697,9,0,291
53053.3468053,2201,0,346,2547,9,0,291
53153.3511695,2005,0,388,2393,10,0,290
53255.3199467,1813,0,456,2269,10,0,290
53355.5126479,1645,0,493,2138,10,0,290
53455.7395147,1459,0,555,2014,11,0,289
53556.0495849,1325,0,625,1950,14,0,286
53656.1449533,1190,0,693,1883,14,0,286
53756.3988593,1082,0,766,1848,14,0,286
53856.615611,964,0,840,1804,16,0,284
53956.6338063,873,0,929,1802,16,0,284
54056.6845054,793,0,1012,1805,17,0,283
54156.6972604,722,0,1041,1763,18,0,282
54257.0636676,663,0,1152,1815,20,0,280
54357.1021186,595,0,1245,1840,20,0,280
54457.2048141,540,0,1359,1899,20,0,280
54557.9981144,490,0,1437,1927,21,0,279
54658.6094053,438,0,1511,1949,22,0,278
54759.1560543,395,0,1586,1981,22,0,278
54859.1970322,354,0,1659,2013,24,0,276
54959.5930286,323,0,1718,2041,24,0,276
55059.8275034,297,0,1802,2099,25,0,275
55160.1926375,270,0,1842,2112,25,0,275
55260.2476919,250,0,1878,2128,27,0,273
55360.3729619,228,0,1918,2146,27,0,273
55460.9568468,211,0,1934,2145,28,0,272
55560.9876676,191,0,2020,2211,28,0,272
55661.5042367,176,0,2126,2302,28,0,272
55761.5395059,156,0,2187,2343,29,0,271
55861.8311145,140,0,2265,2405,30,0,270
55961.9530502,126,0,2335,2461,30,0,270
56062.2108069,116,0,2425,2541,31,0,269
56163.1869644,105,0,2494,2599,31,0,269
56263.4257308,91,0,2583,2674,33,0,267
56363.4982965,85,0,2631,2716,33,0,267
56463.9628703,77,0,2691,2768,34,0,266
56564.1691191,68,0,2757,2825,34,0,266
56664.5232753,62,0,2829,2891,35,0,265
56764.6940094,53,0,2904,2957,35,0,265
56864.7460996,47,0,2979,3026,35,0,265
56964.7657297,43,0,3011,3054,35,0,265
57064.7659864,39,0,3058,3097,35,0,265
57164.8583033,36,0,3084,3120,38,0,262
57264.9511918,34,0,3154,3188,39,0,261
57365.2509906,32,0,3250,3282,39,0,261
57465.2841914,31,0,3267,3298,39,0,261
57565.5261808,24,0,3370,3394,40,0,260
57665.5874604,23,0,3446,3469,41,0,259
57765.6533228,21,0,3501,3522,42,0,258
57865.7927922,18,0,3577,3595,42,0,258
57966.1822914,16,0,3640,3656,42,0,258
58066.2642892,16,0,3674,3690,43,0,257
58166.3252717,14,0,3761,3775,43,0,257
58266.3829043,13,0,3824,3837,43,0,257
58366.3850715,12,0,3902,3914,44,0,256
58466.4071909,10,0,3936,3946,45,0,255
58566.679419,9,0,3974,3983,45,0,255
58666.6848249,9,0,4017,4026,46,0,254
58766.7113439,9,0,4084,4093,46,0,254
58866.7732272,9,0,4148,4157,46,0,254
58966.7846971,9,0,4217,4226,46,0,254
59066.8741229,8,0,4214,4222,46,0,254
59166.8787657,7,0,4240,4247,46,0,254
59267.1346726,4,0,4297,4301,47,0,253
59367.1416404,4,0,4369,4373,47,0,253
59467.2699125,4,0,4438,4442,48,0,252
59567.3785343,3,0,4458,4461,49,0,251
59667.4230643,3,0,4542,4545,51,0,249
59767.5076142,3,0,4671,4674,51,0,249
59867.8170414,2,0,4713,4715,51,0,249
59967.8847938,1,0,4738,4739,51,0,249
60067.8859153,1,0,4801,4802,51,0,249
60168.0417787,1,0,4846,4847,53,0,247
60268.162375,1,0,4885,4886,53,0,247
60368.1681343,1,0,4908,4909,53,0,247
60468.1912339,1,0,4932,4933,53,0,247
60568.2974077,0,10,4717,4727,3,0,297
60668.6341823,0,45,4269,4314,5,0,295
60769.0075266,0,83,3866,3949,5,0,295
60869.1505544,0,121,3483,3604,5,0,295
60969.2818246,0,175,3163,3338,7,0,293
61069.3591934,0,259,2836,3095,8,0,292
61169.4374394,0,307,2542,2849,8,0,292
61270.1776085,0,342,2292,2634,9,0,291
61370.3617682,0,398,2068,2466,10,0,290
61470.430693,0,450,1877,2327,10,0,290
61570.7459066,0,491,1704,2195,11,0,289
61670.9477921,0,567,1530,2097,11,0,289
61770.9904466,0,638,1379,2017,12,0,288
61871.4903504,0,717,1251,1968,12,0,288
61972.2294536,0,761,1129,1890,14,0,286
62072.3430868,0,825,1031,1856,15,0,285
62173.2358025,0,900,927,1827,16,0,284
62273.3299954,0,1008,852,1860,16,0,284
62373.4199209,0,1055,773,1828,16,0,284
62473.6790303,0,1093,696,1789,16,0,284
62573.7499564,0,1168,637,1805,17,0,283
62674.3379605,0,1226,573,1799,18,0,282
62774.5044495,0,1287,514,1801,19,0,281
62875.4194725,0,1326,469,1795,20,0,280
62975.5579929,0,1396,423,1819,20,0,280
63076.38682,0,1454,379,1833,20,0,280
63177.4047536,0,1521,331,1852,20,0,280
63277.8658925,0,1574,300,1874,20,0,280
63379.4913414,0,1625,273,1898,21,0,279
63479.5748582,0,1670,236,1906,23,0,277
63579.7223227,0,1748,204,1952,25,0,275
63679.9782626,0,1803,185,1988,28,0,272
63780.0624372,0,1915,165,2080,29,0,271
63880.0936249,0,2033,150,2183,31,0,269
63980.4175429,0,2128,136,2264,31,0,269
64080.6202298,0,2216,117,2333,31,0,269
64180.7213384,0,2293,107,2400,32,0,268
64281.0190839,0,2373,99,2472,32,0,268
64381.0710626,0,2465,85,2550,32,0,268
64481.1324395,0,2537,76,2613,32,0,268
64581.3151905,0,2593,69,2662,32,0,268
64681.3472937,0,2655,66,2721,32,0,268
64781.3968314,0,2732,59,2791,32,0,268
64881.5857465,0,2745,56,2801,32,0,268
64981.7085486,0,2766,52,2818,32,0,268
65082.061245,0,2819,47,2866,32,0,268
65182.5951637,0,2857,43,2900,33,0,267
65282.7825935,0,2933,39,2972,33,0,267
65383.1852779,0,2939,35,2974,34,0,266
65483.3626811,0,2978,33,3011,34,0,266
65583.4103327,0,2963,29,2992,34,0,266
65683.4214,0,3018,26,3044,34,0,266
65783.5371231,0,3016,21,3037,34,0,266
65883.7429276,0,3039,20,3059,36,0,264
65983.8264947,0,3096,20,3116,37,0,263
66083.8985512,0,3203,19,3222,39,0,261
66184.1819958,0,3272,16,3288,39,0,261
66284.224573,0,3331,16,3347,39,0,261
66384.3340446,0,3396,14,3410,40,0,260
66484.3915415,0,3418,13,3431,41,0,259
66584.6684565,0,3508,12,3520,42,0,258
66684.6950036,0,3589,11,3600,43,0,257
66784.708312,0,3677,10,3687,44,0,256
66884.8537767,0,3739,10,3749,45,0,255
66984.9052218,0,3778,9,3787,45,0,255
67085.199118,0,3819,8,3827,45,0,255
67185.5226121,0,3843,6,3849,45,0,255
67285.7470586,0,3941,6,3947,45,0,255
67385.84973,0,3963,6,3969,45,0,255
67485.9750576,0,3977,6,3983,46,0,254
67586.0735114,0,4044,5,4049,47,0,253
67686.0767602,0,4072,5,4077,47,0,253
67786.2046884,0,4148,4,4152,48,0,252
67886.2840778,0,4215,4,4219,48,0,252
67986.5948303,0,4298,4,4302,48,0,252
68086.6436081,0,4372,4,4376,48,0,252
68186.7792832,0,4478,4,4482,48,0,252
68286.8235173,0,4513,2,4515,48,0,252
68387.1199052,1,4262,2,4265,0,0,300
68487.1898706,1,3843,2,3846,0,0,300
68587.4832655,1,3504,2,3507,0,0,300
68687.5764732,0,3189,2,3191,0,0,300
68787.8119188,0,2904,2,2906,1,0,299
68888.3843928,0,2622,2,2624,2,0,298
68988.5702568,0,2400,2,2402,2,0,298
69088.6032938,0,2200,2,2202,2,0,298
69188.6431732,0,2021,2,2023,5,0,295
69289.6030301,0,1903,2,1905,6,0,294
69389.9241548,0,1794,2,1796,7,0,293
69490.1107389,0,1668,2,1670,8,0,292
69590.2038158,0,1609,0,1609,9,0,291
69690.2929385,4,1532,0,1536,2,0,298
69791.0430838,34,1371,0,1405,3,0,297
69891.074218,66,1230,0,1296,5,0,295
69991.0779672,103,1109,0,1212,5,0,295
70091.1693259,148,1025,0,1173,5,0,295
70191.6985404,186,930,0,1116,7,0,293
70291.7794849,241,853,0,1094,7,0,293
70392.0883399,275,783,0,1058,7,0,293
70493.2323438,295,707,0,1002,8,0,292
70594.4676494,318,641,0,959,8,0,292
70694.6133258,370,569,0,939,8,0,292
70796.2076287,416,527,0,943,10,0,290
70896.9426466,474,473,0,947,11,0,289
70996.9921725,541,429,0,970,13,0,287
71097.1756133,646,378,0,1024,19,0,281
71197.1821655,773,350,0,1123,19,0,281
71297.4743975,890,317,0,1207,19,0,281
71397.6225012,1011,281,0,1292,21,0,279
71497.6420427,1117,255,0,1372,21,0,279
71597.721284,1210,231,0,1441,21,0,279
71697.8346393,1306,210,0,1516,21,0,279
71797.8671744,1381,184,0,1565,21,0,279
71898.1125227,1453,164,0,1617,23,0,277
71998.5074992,1515,145,0,1660,23,0,277
72098.7991077,1590,124,0,1714,23,0,277
72199.0455353,1627,114,0,1741,23,0,277
72299.3120762,1676,102,0,1778,23,0,277
72400.2390241,1766,92,0,1858,27,0,273
72500.4067819,1873,87,0,1960,27,0,273
72600.5036291,1962,80,0,2042,27,0,273
72700.5865598,2016,74,0,2090,27,0,273
72800.9025255,2053,69,0,2122,27,0,273
72901.1842416,2150,66,0,2216,29,0,271
73001.4072878,2215,63,0,2278,32,0,268
73101.7619994,2254,55,0,2309,32,0,268
73201.8619446,2356,50,0,2406,32,0,268
73301.9180913,2464,44,0,2508,33,0,267
73402.0495037,2565,42,0,2607,33,0,267
73502.1322854,2608,37,0,2645,33,0,267
73602.2490489,2702,37,0,2739,35,0,265
73702.329903,2760,36,0,2796,35,0,265
73802.4886863,2801,34,0,2835,35,0,265
73902.5561392,2896,33,0,2929,36,0,264
74002.6399924,2992,29,0,3021,36,0,264
74102.9666562,3025,27,0,3052,36,0,264
74202.96973,3084,26,0,3110,37,0,263
74303.0120198,3145,26,0,3171,37,0,263
74403.0560006,3173,25,0,3198,38,0,262
74503.6677146,3210,23,0,3233,38,0,262
74603.7127604,3208,22,0,3230,39,0,261
74703.742818,3306,20,0,3326,42,0,258
74803.8818285,3377,19,0,3396,42,0,258
74904.2172884,3477,19,0,3496,43,0,257
75004.2757309,3537,16,0,3553,44,0,256
75104.3424246,3636,13,0,3649,44,0,256
75204.6269688,3682,11,0,3693,44,0,256
75304.6983517,3347,9,1,3357,0,0,300
75404.9568366,3044,8,1,3053,0,0,300
75505.4937535,2753,7,1,2761,0,0,300
75605.511694,2498,7,1,2506,0,0,300
75706.3849457,2269,7,2,2278,0,0,300
75806.3872783,2059,7,1,2067,0,0,300
75906.6578796,1873,6,1,1880,0,0,300
76007.2360567,1704,5,0,1709,0,0,300
76107.4138416,1551,5,0,1556,2,0,298
76207.5961186,1418,4,0,1422,4,0,296
76307.6778489,1309,4,0,1313,4,0,296
76408.830996,1212,4,0,1216,5,0,295
76509.0338553,1143,4,0,1147,7,0,293
76609.3884803,1121,3,0,1124,7,0,293
76710.0175644,1019,3,1,1023,0,0,300
76810.3332238,908,3,1,912,0,0,300
76914.0972704,832,2,1,835,0,0,300
77015.3210054,754,2,1,757,0,0,300
77117.4518907,658,1,1,660,0,0,300
77217.4635078,595,1,1,597,0,0,300
77319.6967706,539,1,1,541,0,0,300
77421.1045165,486,1,1,488,0,0,300
77522.7196334,432,0,1,433,0,0,300
77624.8236166,385,0,4,389,1,0,299
77725.2695846,342,0,8,350,1,0,299
77827.1208408,312,0,14,326,1,0,299
77928.4195085,287,0,22,309,1,0,299
78028.5996657,260,0,31,291,2,0,298
78128.850134,234,0,47,281,2,0,298
78229.0295962,209,0,60,269,2,0,298
78333.8412243,192,0,75,267,2,0,298
78436.104369,170,0,83,253,3,0,297
78537.9149622,152,0,115,267,4,0,296
78639.4154309,133,0,120,253,5,0,295
78744.5860292,121,0,165,286,5,0,295
78845.278582,112,0,205,317,5,0,295
78946.97509,102,0,242,344,5,0,295
79049.5450386,92,0,256,348,5,0,295
79151.793814,88,0,277,365,6,0,294
79254.202563,82,0,296,378,6,0,294
79355.4803212,76,0,326,402,6,0,294
79455.9328083,69,0,377,446,6,0,294
79556.4368808,67,0,395,462,7,0,293
79656.46265,58,0,431,489,7,0,293
79756.9850166,52,0,469,521,8,0,292
79862.3065482,48,0,493,541,9,0,291
79962.3088607,46,0,539,585,11,0,289
80063.6470244,39,0,581,620,11,0,289
80163.823145,37,0,623,660,11,0,289
80264.3464535,33,0,668,701,11,0,289
80364.4966456,30,0,723,753,12,0,288
80465.9397358,27,0,781,808,14,0,286
80566.1201015,23,0,863,886,14,0,286
80666.1904468,22,0,923,945,15,0,285
80766.6005307,21,0,975,996,15,0,285
80866.8026187,17,0,1035,1052,15,0,285
80966.869461,14,0,1094,1108,17,0,283
81066.8749806,13,0,1157,1170,17,0,283
81166.973898,12,0,1223,1235,21,0,279
81267.0271113,11,0,1273,1284,22,0,278
81367.1659372,10,0,1367,1377,23,0,277
81467.3901802,9,0,1449,1458,23,0,277
81567.5178548,9,1,1462,1472,0,0,300
81667.619788,9,1,1319,1329,0,0,300
81767.8382277,8,1,1197,1206,0,0,300
81869.0567621,6,1,1096,1103,0,0,300
81969.4718465,5,1,1003,1009,1,0,299
82069.7193789,5,1,911,917,0,0,300
82170.0655626,3,0,825,828,0,0,300
82270.9092129,3,0,744,747,2,0,298
82371.1055991,2,0,694,696,3,0,297
82472.1003233,2,0,655,657,3,0,297
82572.6670915,2,0,613,615,4,0,296
82672.7222299,1,0,626,627,6,0,294
82772.7706504,1,0,642,643,7,0,293
82873.5369622,1,0,653,654,7,0,293
82974.9219388,1,0,655,656,7,0,293
83075.6894467,1,0,654,655,7,0,293
83176.6402421,1,3,618,622,0,0,300
83277.5552278,1,3,547,551,0,0,300
83377.9338293,1,3,502,506,0,0,300
83484.9747807,1,3,452,456,0,0,300
83586.6247054,1,3,408,412,0,0,300
83690.3422694,1,4,376,381,0,0,300
83797.2193219,1,3,337,341,0,0,300
83897.4212008,0,3,302,305,0,0,300
83999.2344812,0,8,275,283,1,0,299
84099.8156818,0,16,251,267,1,0,299
84200.2125624,0,23,231,254,1,0,299
84305.600511,0,36,201,237,2,0,298
84406.2158626,0,67,181,248,5,0,295
84510.4936155,0,110,163,273,5,0,295
84613.1948543,0,147,144,291,5,0,295
84713.4847813,0,189,131,320,6,0,294
84814.3946502,0,238,121,359,8,0,292
84915.9383337,0,302,107,409,10,0,290
85017.6835016,0,367,96,463,11,0,289
85117.8540353,0,458,88,546,12,0,288
85218.128248,0,533,81,614,14,0,286
85318.3199414,0,630,77,707,17,0,283
85418.8681987,0,751,72,823,18,0,282
85519.316589,0,845,64,909,18,0,282
85619.4857711,0,946,54,1000,18,0,282
85720.0155056,0,1012,50,1062,19,0,281
85820.1192959,0,1083,43,1126,19,0,281
85920.8890962,0,1163,40,1203,20,0,280
86020.9615914,0,1243,35,1278,22,0,278
86121.1615589,0,1345,35,1380,22,0,278
86222.0965341,0,1474,32,1506,23,0,277
86322.1558025,0,1563,29,1592,25,0,275
86422.5559975,0,1639,25,1664,28,0,272
86522.5872739,0,1723,24,1747,28,0,272
86622.718058,0,1840,23,1863,29,0,271
86722.860049,0,1979,19,1998,30,0,270
86823.036102,0,2067,18,2085,32,0,268
86923.4512364,0,2172,15,2187,33,0,267
87023.5254545,0,2340,15,2355,33,0,267
87123.5980832,0,2451,14,2465,34,0,266
87223.6458784,0,2562,12,2574,34,0,266
87323.7712347,0,2669,10,2679,35,0,265
87423.9963817,0,2729,8,2737,36,0,264
87524.0335047,0,2849,8,2857,37,0,263
87624.0498546,0,2936,7,2943,38,0,262
87724.0925561,0,3042,7,3049,39,0,261
87824.3129093,0,3122,7,3129,39,0,261
87924.5676906,0,3198,6,3204,39,0,261
88024.6884988,0,3328,6,3334,41,0,259
88124.9993467,0,3388,6,3394,41,0,259
88225.2336739,0,3438,5,3443,41,0,259
88325.7252192,0,3437,4,3441,41,0,259
88425.8528285,0,3520,3,3523,42,0,258
88525.8554012,0,3605,3,3608,44,0,256
88626.2074079,0,3718,3,3721,44,0,256
88726.2940391,0,3768,3,3771,44,0,256
88826.2994485,0,3841,2,3843,46,0,254
88926.4490148,0,3908,2,3910,46,0,254
89026.45691,0,3988,2,3990,47,0,253
89126.5839739,0,4095,2,4097,47,0,253
89226.7270598,0,4162,2,4164,49,0,251
89327.0659123,0,4200,2,4202,49,0,251
89427.236779,0,4300,2,4302,50,0,250
89527.3404539,0,4379,1,4380,51,0,249
89627.34846,0,4437,1,4438,51,0,249
89727.5033035,0,4492,1,4493,51,0,249
89827.6098067,0,4564,1,4565,51,0,249
89927.7120964,1,4250,1,4252,0,0,300
90027.7955545,1,3867,1,3869,0,0,300
90128.2795213,1,3512,1,3514,0,0,300
90228.4282732,2,3189,1,3192,0,0,300
90328.6186105,2,2906,1,2909,0,0,300
90429.4682267,1,2627,1,2629,0,0,300
90529.8591271,1,2382,1,2384,1,0,299
90630.8255165,1,2155,1,2157,0,0,300
90730.920605,1,1948,1,1950,0,0,300
